53
22
2
4
4444444444444444444444444444444444444444444444444444
4333343333433334333343333433334333343333433334433334
4333343333433334333343333433334333343333433334433444
4333343333433334333343333433334333343333433334433443
4644446444464444644443333444464444644446444464433443
4333333333333333333333333333333333333333333334433333
4644446444464444644443333444464444644446444464433443
4333343333433334333343333433334333343333433334433443
4333343333433334333343333433334333343333433334433443
4333343333433334333343333433334333343333433334433444
4444444444444444444443333444444444444444444444433344
4444333334433333333333333333333333344333334444433334
4443333334333333333333333333333333334333333444443334
4433333333333333333333333333333333333333333344444334
4333333333333333333333333333333333333333333334444334
4444444444333333333333333333333333334444444444444334
4444444444433333333333333333333333344444434444433334
4444444444444444444444664444444444444444434444444334
4444444444444444443333333333333333333333333333333334
4444444444444444443433333333333333333333333333333334
4444444444444444444444344444444444444444444444444444