53
22
2
4
4333333333333333333333333333333333333333333333333334
3333333333333333333333333333333333333333333333333333
3333333333333333333333333333333333333333333333333333
3333333333333333333333333333333333333333333333333333
3333333333333333333333333333333333333333333333333333
3333333333333333333333333333333333333333333333333333
3333333333333333333333333333333333333333333333333333
3333333333333333333333344444433333333333333333333333
3333333333333333333333343333433333333333333333333333
3333333333333333333333343333433333333333333333333333
3333333333333333333333344444433333333333333333333333
3333333333333333333333333333333333333333333333333333
3333333333333333333333333333333333333333333333333333
3333333333333333333333333333333333333333333333333333
3333333333333333333333333333333333333333333333333333
3333333333333333333333333333333333333333333333333333
3333333333333333333333333333333333333333333333333333
3333333333333333333333333333333333333333333333333333
3333333333333333333333333333333333333333333333333333
3333333333333333333333333333333333333333333333333333
4444444444444444444444344444444444444444444444444444